{
  "matrix_map":
  [[3, 2, 2, 3, 1, 3, 3, 2, 1, 3, 1, 1, 3, 5, 2, 3, 1, 5, 5, 3, 4, 3, 2, 2, 1, 2, 4, 1, 1, 1],
    [1, 2, 0, 0, 0, 0, 4, 0, 0, 0, 0, 0, 0, 3, 0, 0, 0, 4, 3, 0, 0, 0, 0, 0, 0, 0, 0, 0, 0, 1],
    [1, 1, 0, 0, 0, 0, 2, 0, 0, 0, 0, 0, 0, 2, 0, 0, 0, 1, 4, 0, 0, 0, 0, 0, 0, 0, 0, 0, 0, 1],
    [1, 1, 0, 0, 0, 0, 0, 0, 0, 0, 0, 0, 0, 2, 0, 0, 0, 2, 2, 0, 0, 0, 0, 0, 0, 0, 0, 0, 0, 1],
    [1, 1, 0, 0, 0, 0, 0, 0, 0, 0, 0, 0, 0, 0, 0, 0, 0, 1, 3, 0, 0, 0, 0, 0, 0, 0, 0, 0, 0, 1],
    [1, 1, 0, 0, 0, 0, 3, 0, 0, 0, 0, 0, 0, 0, 0, 0, 0, 3, 3, 0, 0, 0, 0, 0, 0, 0, 0, 0, 0, 1],
    [1, 1, 0, 0, 0, 0, 1, 0, 0, 0, 0, 0, 0, 0, 0, 0, 0, 1, 3, 1, 2, 1, 1, 2, 3, 4, 0, 0, 1, 1],
    [1, 1, 0, 0, 0, 0, 1, 2, 3, 2, 2, 0, 0, 2, 1, 1, 2, 1, 2, 0, 0, 0, 0, 0, 0, 0, 0, 0, 0, 1],
    [1, 1, 0, 0, 0, 0, 1, 2, 2, 1, 4, 0, 0, 1, 1, 1, 3, 1, 3, 0, 0, 0, 0, 0, 0, 0, 0, 0, 0, 1],
    [1, 1, 2, 0, 0, 4, 2, 1, 1, 1, 1, 0, 0, 1, 1, 1, 1, 1, 3, 0, 0, 0, 0, 0, 0, 0, 0, 0, 0, 1],
    [1, 1, 1, 0, 0, 2, 3, 1, 1, 1, 1, 0, 0, 1, 1, 1, 1, 1, 3, 0, 0, 0, 0, 0, 0, 0, 0, 0, 0, 1],
    [1, 1, 2, 0, 0, 1, 1, 1, 0, 0, 0, 0, 0, 0, 0, 0, 0, 0, 1, 0, 0, 0, 0, 0, 0, 0, 0, 0, 0, 1],
    [1, 1, 5, 0, 0, 2, 3, 1, 0, 0, 0, 0, 0, 0, 0, 0, 0, 0, 1, 0, 0, 0, 0, 0, 0, 0, 0, 0, 0, 1],
    [1, 0, 0, 0, 0, 0, 0, 1, 0, 0, 0, 0, 0, 2, 0, 0, 0, 0, 3, 0, 0, 0, 0, 0, 0, 0, 0, 0, 0, 1],
    [2, 0, 0, 0, 0, 0, 0, 1, 0, 0, 0, 0, 0, 3, 0, 0, 0, 0, 1, 1, 1, 1, 1, 0, 0, 2, 3, 1, 1, 1],
    [3, 0, 0, 0, 0, 0, 0, 1, 0, 0, 0, 2, 3, 2, 0, 0, 0, 0, 1, 1, 1, 1, 2, 0, 0, 1, 1, 1, 1, 1],
    [3, 0, 0, 0, 0, 0, 0, 1, 0, 0, 0, 3, 4, 5, 0, 0, 0, 0, 5, 2, 3, 1, 2, 0, 0, 1, 1, 1, 1, 1],
    [1, 0, 0, 0, 0, 0, 0, 1, 0, 0, 0, 1, 2, 1, 0, 0, 0, 0, 0, 0, 0, 0, 0, 0, 0, 2, 1, 1, 1, 1],
    [2, 0, 0, 0, 0, 0, 0, 1, 0, 0, 0, 0, 0, 0, 0, 0, 0, 0, 0, 0, 0, 0, 0, 0, 0, 1, 1, 1, 1, 1],
    [5, 0, 0, 0, 0, 0, 0, 1, 0, 0, 0, 0, 0, 0, 0, 0, 0, 0, 0, 0, 0, 0, 0, 0, 0, 3, 2, 1, 1, 1],
    [2, 0, 0, 0, 0, 0, 0, 1, 0, 0, 0, 0, 0, 0, 0, 0, 0, 0, 0, 0, 0, 0, 0, 0, 0, 1, 1, 1, 1, 1],
    [2, 0, 0, 0, 0, 0, 0, 1, 1, 1, 1, 2, 1, 1, 2, 2, 3, 1, 2, 1, 1, 1, 1, 1, 1, 1, 1, 1, 1, 1],
    [1, 1, 0, 0, 3, 1, 1, 1, 1, 1, 1, 2, 2, 1, 1, 1, 1, 1, 1, 1, 1, 1, 1, 1, 1, 1, 1, 1, 1, 1],
    [3, 5, 0, 0, 1, 0, 0, 0, 0, 0, 0, 0, 0, 0, 0, 1, 1, 1, 1, 0, 0, 0, 0, 0, 0, 0, 0, 0, 0, 1],
    [3, 3, 0, 0, 1, 0, 0, 0, 0, 0, 0, 0, 0, 0, 0, 1, 1, 1, 3, 0, 0, 0, 0, 0, 0, 0, 0, 0, 0, 1],
    [5, 2, 0, 0, 0, 0, 0, 0, 0, 0, 0, 0, 0, 0, 0, 0, 0, 0, 0, 0, 0, 0, 0, 0, 0, 0, 0, 0, 0, 1],
    [2, 1, 0, 0, 0, 0, 0, 0, 0, 0, 0, 0, 0, 0, 0, 0, 0, 0, 0, 0, 0, 0, 0, 0, 0, 0, 0, 0, 0, 1],
    [1, 1, 1, 3, 2, 0, 0, 0, 0, 0, 0, 0, 0, 0, 0, 5, 1, 2, 2, 0, 0, 0, 0, 0, 0, 0, 0, 0, 0, 1],
    [1, 3, 1, 1, 1, 0, 0, 0, 0, 0, 0, 0, 0, 0, 0, 1, 1, 1, 2, 0, 0, 0, 0, 0, 0, 0, 0, 0, 0, 1],
    [2, 3, 4, 1, 3, 3, 3, 2, 5, 3, 1, 3, 5, 3, 5, 2, 3, 3, 1, 3, 3, 1, 3, 5, 4, 3, 1, 1, 1, 1]],
  "player": {
    "start_pos": [28, 24.5],
    "angle": 180,
    "speed": 2
  },
  "entities": [
    {
      "id": "brain_evil",
      "pos": [22.5, 26.5]
    },
    {
      "id": "bullet_pack",
      "pos": [5.5, 23.5]
    },
    {
      "id": "health_pack",
      "pos": [29.5, 29.5]
    },
    {
      "id": "soldier",
      "pos": [21.5, 8.5]
    },
    {
      "id": "soldier",
      "pos": [8.5, 27.5]
    },
    {
      "id": "soldier",
      "pos": [3.5, 16.5]
    },
    {
      "id": "soldier",
      "pos": [4.5, 4.5]
    },
    {
      "id": "soldier",
      "pos": [10.5, 24.5]
    },
    {
      "id": "soldier",
      "pos": [10.5, 16.5]
    },
    {
      "id": "soldier",
      "pos": [16.5, 18.5]
    },
    {
      "id": "soldier",
      "pos": [23.5, 10.5]
    },
    {
      "id": "soldier",
      "pos": [22.5, 2.5]
    }
  ]
}