{
  "matrix_map":
  [[3, 2, 2, 3, 1, 3, 3, 2, 1, 3, 1, 1, 3, 5, 2, 3, 1, 5, 5, 3, 4, 3, 2, 2, 1, 2, 4, 1, 1, 1],
    [1, 2, 0, 0, 0, 0, 4, 0, 0, 0, 0, 0, 0, 3, 0, 0, 0, 4, 3, 0, 0, 0, 0, 0, 0, 0, 0, 0, 0, 1],
    [1, 1, 0, 0, 0, 0, 2, 0, 0, 0, 0, 0, 0, 2, 0, 0, 0, 1, 4, 0, 0, 0, 0, 0, 0, 0, 0, 0, 0, 1],
    [1, 1, 0, 0, 0, 0, 0, 0, 0, 0, 0, 0, 0, 2, 0, 0, 0, 2, 2, 0, 0, 0, 0, 0, 0, 0, 0, 0, 0, 1],
    [1, 1, 0, 0, 0, 0, 0, 0, 0, 0, 0, 0, 0, 0, 0, 0, 0, 1, 3, 0, 0, 0, 0, 0, 0, 0, 0, 0, 0, 1],
    [1, 1, 0, 0, 0, 0, 3, 0, 0, 0, 0, 0, 0, 0, 0, 0, 0, 3, 3, 0, 0, 0, 0, 0, 0, 0, 0, 0, 0, 1],
    [1, 1, 0, 0, 0, 0, 1, 0, 0, 0, 0, 0, 0, 0, 0, 0, 0, 1, 3, 1, 2, 1, 1, 2, 3, 4, 0, 0, 1, 1],
    [1, 1, 0, 0, 0, 0, 1, 2, 3, 2, 2, 0, 0, 2, 1, 1, 2, 1, 2, 0, 0, 0, 0, 0, 0, 0, 0, 0, 0, 1],
    [1, 1, 0, 0, 0, 0, 1, 2, 2, 1, 4, 0, 0, 1, 1, 1, 3, 1, 3, 0, 0, 0, 0, 0, 0, 0, 0, 0, 0, 1],
    [1, 1, 2, 0, 0, 4, 2, 1, 1, 1, 1, 0, 0, 1, 1, 1, 1, 1, 3, 0, 0, 0, 0, 0, 0, 0, 0, 0, 0, 1],
    [1, 1, 1, 0, 0, 2, 3, 1, 1, 1, 1, 0, 0, 1, 1, 1, 1, 1, 3, 0, 0, 0, 0, 0, 0, 0, 0, 0, 0, 1],
    [1, 1, 2, 0, 0, 1, 1, 1, 0, 0, 0, 0, 0, 0, 0, 0, 0, 0, 1, 0, 0, 0, 0, 0, 0, 0, 0, 0, 0, 1],
    [1, 1, 5, 0, 0, 2, 3, 1, 0, 0, 0, 0, 0, 0, 0, 0, 0, 0, 1, 0, 0, 0, 0, 0, 0, 0, 0, 0, 0, 1],
    [1, 0, 0, 0, 0, 0, 0, 1, 0, 0, 0, 0, 0, 2, 0, 0, 0, 0, 3, 0, 0, 0, 0, 0, 0, 0, 0, 0, 0, 1],
    [2, 0, 0, 0, 0, 0, 0, 1, 0, 0, 0, 0, 0, 3, 0, 0, 0, 0, 1, 1, 1, 1, 1, 0, 0, 2, 3, 1, 1, 1],
    [3, 0, 0, 0, 0, 0, 0, 1, 0, 0, 0, 2, 3, 2, 0, 0, 0, 0, 1, 1, 1, 1, 2, 0, 0, 1, 1, 1, 1, 1],
    [3, 0, 0, 0, 0, 0, 0, 1, 0, 0, 0, 3, 4, 5, 0, 0, 0, 0, 5, 2, 3, 1, 2, 0, 0, 1, 1, 1, 1, 1],
    [1, 0, 0, 0, 0, 0, 0, 1, 0, 0, 0, 1, 2, 1, 0, 0, 0, 0, 0, 0, 0, 0, 0, 0, 0, 2, 1, 1, 1, 1],
    [2, 0, 0, 0, 0, 0, 0, 1, 0, 0, 0, 0, 0, 0, 0, 0, 0, 0, 0, 0, 0, 0, 0, 0, 0, 1, 1, 1, 1, 1],
    [5, 0, 0, 0, 0, 0, 0, 1, 0, 0, 0, 0, 0, 0, 0, 0, 0, 0, 0, 0, 0, 0, 0, 0, 0, 3, 2, 1, 1, 1],
    [2, 0, 0, 0, 0, 0, 0, 1, 0, 0, 0, 0, 0, 0, 0, 0, 0, 0, 0, 0, 0, 0, 0, 0, 0, 1, 1, 1, 1, 1],
    [2, 0, 0, 0, 0, 0, 0, 1, 1, 1, 1, 2, 1, 1, 2, 2, 3, 1, 2, 1, 1, 1, 1, 1, 1, 1, 1, 1, 1, 1],
    [1, 1, 0, 0, 3, 1, 1, 1, 1, 1, 1, 2, 2, 1, 1, 1, 1, 1, 1, 1, 1, 1, 1, 1, 1, 1, 1, 1, 1, 1],
    [3, 5, 0, 0, 1, 0, 0, 0, 0, 0, 0, 0, 0, 0, 0, 1, 1, 1, 1, 0, 0, 0, 0, 0, 0, 0, 0, 0, 0, 1],
    [3, 3, 0, 0, 1, 0, 0, 0, 0, 0, 0, 0, 0, 0, 0, 1, 1, 1, 3, 0, 0, 0, 0, 0, 0, 0, 0, 0, 0, 1],
    [5, 2, 0, 0, 0, 0, 0, 0, 0, 0, 0, 0, 0, 0, 0, 0, 0, 0, 0, 0, 0, 0, 0, 0, 0, 0, 0, 0, 0, 1],
    [2, 1, 0, 0, 0, 0, 0, 0, 0, 0, 0, 0, 0, 0, 0, 0, 0, 0, 0, 0, 0, 0, 0, 0, 0, 0, 0, 0, 0, 1],
    [1, 1, 1, 3, 2, 0, 0, 0, 0, 0, 0, 0, 0, 0, 0, 5, 1, 2, 2, 0, 0, 0, 0, 0, 0, 0, 0, 0, 0, 1],
    [1, 3, 1, 1, 1, 0, 0, 0, 0, 0, 0, 0, 0, 0, 0, 1, 1, 1, 2, 0, 0, 0, 0, 0, 0, 0, 0, 0, 0, 1],
    [2, 3, 4, 1, 3, 3, 3, 2, 5, 3, 1, 3, 5, 3, 5, 2, 3, 3, 1, 3, 3, 1, 3, 5, 4, 3, 1, 1, 1, 1]],
  "player": {
    "start_pos": [28, 24.5],
    "angle": 180,
    "speed": 2
  },
  "entities": [
    {
      "id": "brain_evil",
      "pos": [9.5, 25.5]
    },
    {
      "id": "unactive_column",
      "pos": [5.5, 23.5]
    },
    {
      "id": "health_pack",
      "pos": [11.5, 8.5]
    },
    {
      "id": "soldier",
      "pos": [2.5, 17.5]
    },
    {
      "id": "soldier",
      "pos": [2.5, 7.5]
    },
    {
      "id": "brain_evil",
      "pos": [10.5, 5.5]
    },
    {
      "id": "soldier",
      "pos": [15.5, 16.5]
    },
    {
      "id": "soldier",
      "pos": [17.5, 19.5]
    },
    {
      "id": "brain_evil",
      "pos": [21.5, 10.5]
    },
    {
      "id": "soldier",
      "pos": [26.5, 8.5]
    },
    {
      "id": "soldier",
      "pos": [21.5, 2.5]
    },
    {
      "id": "brain_evil",
      "pos": [24.5, 2.5]
    },
    {
      "id": "bullet_pack",
      "pos": [1.5, 15.5]
    },{
      "id": "armor_pack",
      "pos": [14.5, 1.5]
    },
    {
      "id": "bullet_pack",
      "pos": [9.5, 18.5]
    },
    {
      "id": "column",
      "pos": [5.5, 27.5]
    }
  ]
}