{
  "matrix_map":
  [[3, 2, 2, 3, 1, 3, 3, 2, 1, 3, 1, 1, 3, 5, 2, 3, 1, 5, 5, 3, 4, 3, 2, 2, 1, 2, 4, 1, 1, 1],
    [1, 2, 0, 0, 0, 0, 4, 0, 0, 0, 0, 0, 0, 0, 0, 0, 0, 4, 3, 0, 0, 0, 0, 0, 0, 0, 0, 0, 0, 1],
    [1, 1, 0, 0, 0, 0, 2, 0, 0, 0, 0, 0, 0, 0, 0, 0, 0, 1, 4, 0, 0, 0, 0, 0, 0, 0, 0, 0, 0, 1],
    [1, 1, 0, 0, 0, 0, 0, 0, 0, 0, 0, 0, 0, 0, 0, 0, 0, 0, 0, 0, 0, 0, 0, 0, 0, 0, 0, 0, 0, 1],
    [1, 1, 0, 0, 0, 0, 0, 0, 0, 0, 0, 0, 0, 0, 0, 0, 0, 0, 0, 0, 0, 0, 0, 0, 0, 0, 0, 0, 0, 1],
    [1, 1, 0, 0, 0, 0, 3, 0, 0, 0, 0, 0, 0, 0, 0, 0, 0, 3, 3, 0, 0, 0, 0, 0, 0, 0, 0, 0, 0, 1],
    [1, 1, 0, 0, 0, 0, 1, 0, 0, 0, 0, 0, 0, 0, 0, 0, 0, 1, 3, 1, 2, 1, 1, 0, 0, 4, 3, 1, 1, 1],
    [1, 1, 0, 0, 0, 0, 1, 2, 3, 2, 2, 1, 3, 2, 1, 1, 2, 1, 2, 0, 0, 0, 0, 0, 0, 0, 0, 0, 0, 1],
    [1, 1, 0, 0, 0, 0, 1, 2, 2, 1, 4, 5, 1, 1, 1, 1, 3, 1, 3, 0, 0, 0, 0, 0, 0, 0, 0, 0, 0, 1],
    [1, 1, 2, 0, 0, 4, 2, 1, 1, 1, 1, 1, 2, 1, 1, 1, 1, 1, 3, 0, 0, 0, 0, 0, 0, 0, 0, 0, 0, 1],
    [1, 1, 1, 0, 0, 2, 3, 1, 1, 1, 1, 1, 3, 1, 1, 1, 1, 1, 3, 0, 0, 0, 0, 0, 0, 0, 0, 0, 0, 1],
    [1, 1, 2, 0, 0, 1, 1, 1, 1, 2, 1, 1, 2, 1, 2, 1, 1, 1, 1, 0, 0, 0, 0, 0, 0, 0, 0, 0, 0, 1],
    [1, 0, 0, 0, 0, 0, 0, 1, 1, 3, 1, 1, 1, 2, 1, 1, 1, 1, 1, 0, 0, 0, 0, 0, 0, 0, 0, 0, 0, 1],
    [1, 0, 0, 0, 0, 0, 0, 1, 1, 1, 1, 1, 0, 0, 0, 0, 1, 1, 3, 0, 0, 0, 0, 0, 0, 0, 0, 0, 0, 1],
    [2, 0, 0, 0, 0, 0, 0, 1, 1, 2, 1, 1, 0, 0, 0, 0, 1, 1, 1, 1, 1, 1, 1, 1, 1, 2, 3, 1, 1, 1],
    [3, 0, 0, 0, 0, 0, 0, 1, 1, 3, 1, 0, 0, 0, 0, 0, 1, 1, 1, 1, 1, 1, 2, 1, 1, 1, 1, 1, 1, 1],
    [3, 0, 0, 0, 0, 0, 0, 1, 2, 1, 1, 0, 0, 0, 0, 0, 1, 1, 1, 1, 1, 1, 3, 1, 1, 1, 1, 1, 1, 1],
    [1, 0, 0, 0, 0, 0, 0, 1, 1, 4, 1, 0, 0, 0, 0, 0, 0, 0, 0, 0, 0, 0, 0, 0, 0, 2, 1, 1, 1, 1],
    [2, 0, 0, 0, 0, 0, 0, 1, 1, 1, 1, 0, 0, 0, 0, 0, 0, 0, 0, 0, 0, 0, 0, 0, 0, 1, 1, 1, 1, 1],
    [5, 0, 0, 0, 0, 0, 0, 1, 1, 1, 1, 1, 2, 1, 3, 1, 1, 1, 3, 0, 0, 0, 0, 0, 0, 3, 2, 1, 1, 1],
    [2, 0, 0, 0, 0, 0, 0, 1, 1, 1, 1, 1, 1, 4, 5, 2, 2, 1, 5, 2, 0, 0, 0, 0, 0, 1, 1, 1, 1, 1],
    [2, 0, 0, 0, 0, 0, 0, 1, 1, 1, 1, 2, 1, 1, 2, 2, 3, 1, 2, 1, 1, 1, 0, 0, 0, 1, 1, 1, 1, 1],
    [1, 1, 0, 0, 1, 1, 1, 1, 1, 1, 1, 2, 2, 1, 1, 1, 1, 1, 1, 1, 1, 1, 0, 0, 0, 0, 1, 1, 1, 1],
    [3, 5, 0, 0, 1, 0, 0, 0, 0, 0, 0, 0, 0, 0, 0, 1, 1, 1, 1, 3, 1, 0, 0, 0, 0, 0, 0, 0, 0, 1],
    [3, 3, 0, 0, 1, 0, 0, 0, 0, 0, 0, 0, 0, 0, 0, 1, 1, 1, 3, 0, 0, 0, 0, 0, 0, 0, 0, 0, 0, 1],
    [5, 2, 0, 0, 0, 0, 0, 0, 0, 0, 0, 0, 0, 0, 0, 0, 0, 0, 0, 0, 0, 0, 0, 0, 0, 0, 0, 0, 0, 1],
    [2, 1, 0, 0, 0, 0, 0, 0, 0, 0, 0, 0, 0, 0, 0, 0, 0, 0, 0, 0, 0, 0, 1, 0, 0, 0, 0, 0, 0, 1],
    [1, 1, 1, 3, 2, 0, 0, 0, 0, 0, 0, 0, 0, 0, 0, 5, 1, 2, 2, 0, 0, 2, 2, 0, 0, 0, 0, 0, 0, 1],
    [1, 3, 1, 1, 1, 0, 0, 0, 0, 0, 0, 0, 0, 0, 0, 1, 1, 1, 2, 1, 2, 1, 4, 0, 0, 0, 0, 0, 0, 1],
    [2, 3, 4, 1, 3, 3, 3, 2, 5, 3, 1, 3, 5, 3, 5, 2, 3, 3, 1, 3, 3, 1, 3, 5, 4, 3, 1, 1, 1, 1]],
  "player": {
    "start_pos": [28.5, 27.5],
    "angle": 0,
    "speed": 2
  },
  "entities": [
    {
      "id": "test_npc",
      "pos": [19.5, 25.5]
    },
    {
      "id": "test_npc",
      "pos": [7.5, 27.5]
    },
    {
      "id": "test_npc",
      "pos": [4.5, 16.5]
    },
    {
      "id": "test_npc",
      "pos": [3.5, 4.5]
    },
    {
      "id": "test_npc",
      "pos": [11.5, 3.5]
    },
    {
      "id": "test_npc",
      "pos": [21.5, 4.5]
    },
    {
      "id": "test_npc",
      "pos": [21.5, 11.5]
    },
    {
      "id": "test_npc",
      "pos": [25.5, 11.5]
    }

  ]
}