{
  "matrix_map":
  [[3, 2, 2, 3, 1, 3, 3, 2, 1, 3, 1, 1, 3, 5, 2, 3, 1, 5, 5, 3, 4, 3, 2, 2, 1, 2, 4, 1, 1, 1],
    [1, 2, 5, 2, 0, 0, 1, 1, 1, 1, 3, 0, 0, 0, 0, 0, 0, 0, 3, 0, 0, 0, 0, 0, 0, 0, 0, 0, 0, 1],
    [1, 1, 4, 3, 0, 0, 2, 1, 1, 2, 1, 0, 0, 0, 0, 0, 0, 0, 3, 0, 0, 0, 0, 0, 0, 0, 0, 0, 0, 1],
    [1, 1, 3, 4, 0, 0, 2, 1, 1, 3, 1, 0, 0, 0, 0, 0, 0, 0, 3, 0, 0, 0, 0, 0, 0, 0, 0, 0, 0, 1],
    [1, 1, 2, 5, 0, 0, 2, 1, 1, 1, 2, 0, 0, 0, 0, 0, 0, 0, 3, 0, 0, 0, 0, 0, 0, 0, 0, 0, 0, 1],
    [1, 0, 0, 0, 0, 0, 4, 1, 1, 1, 2, 0, 0, 0, 0, 0, 0, 0, 3, 0, 0, 0, 0, 0, 0, 0, 0, 0, 0, 1],
    [1, 0, 0, 0, 0, 0, 1, 2, 1, 4, 2, 1, 2, 1, 1, 0, 0, 0, 3, 1, 2, 1, 1, 2, 0, 0, 3, 1, 1, 1],
    [1, 0, 0, 0, 0, 0, 1, 0, 0, 0, 0, 0, 0, 2, 1, 0, 0, 0, 0, 0, 0, 0, 0, 0, 0, 0, 3, 1, 1, 1],
    [1, 0, 0, 0, 0, 0, 1, 0, 0, 0, 0, 0, 0, 1, 1, 0, 0, 0, 3, 0, 0, 0, 0, 0, 0, 0, 0, 0, 0, 1],
    [1, 0, 2, 3, 0, 0, 2, 0, 0, 0, 0, 0, 0, 1, 1, 0, 0, 0, 3, 0, 0, 0, 0, 0, 0, 0, 0, 0, 0, 1],
    [1, 0, 1, 1, 0, 0, 3, 0, 0, 0, 0, 1, 0, 1, 1, 0, 0, 0, 3, 0, 0, 0, 0, 0, 0, 0, 0, 0, 0, 1],
    [1, 0, 2, 1, 0, 0, 1, 0, 0, 0, 0, 3, 0, 1, 2, 0, 0, 0, 3, 0, 0, 0, 0, 0, 0, 0, 0, 0, 0, 1],
    [1, 0, 2, 1, 0, 0, 1, 0, 0, 0, 0, 2, 0, 2, 1, 0, 0, 0, 0, 0, 0, 0, 0, 0, 0, 0, 0, 0, 0, 1],
    [1, 0, 0, 0, 0, 0, 0, 0, 0, 0, 0, 1, 0, 2, 1, 0, 0, 0, 3, 0, 0, 0, 0, 0, 0, 0, 0, 0, 0, 1],
    [2, 0, 0, 0, 0, 0, 0, 0, 0, 0, 0, 5, 0, 1, 2, 0, 0, 0, 1, 1, 1, 3, 5, 1, 2, 2, 3, 1, 1, 1],
    [3, 0, 0, 0, 0, 0, 0, 0, 0, 0, 0, 1, 0, 0, 0, 0, 0, 0, 0, 0, 0, 0, 0, 0, 1, 1, 2, 1, 1, 1],
    [3, 0, 1, 3, 3, 2, 1, 1, 2, 1, 0, 1, 0, 0, 0, 0, 0, 0, 1, 0, 0, 0, 0, 0, 3, 1, 3, 1, 1, 1],
    [1, 0, 3, 1, 1, 2, 3, 5, 1, 4, 0, 3, 0, 0, 0, 0, 0, 0, 0, 0, 0, 3, 1, 0, 2, 1, 2, 1, 1, 1],
    [2, 0, 0, 0, 0, 0, 0, 0, 0, 0, 0, 2, 0, 0, 0, 0, 0, 0, 2, 0, 0, 0, 0, 0, 3, 5, 4, 1, 1, 1],
    [5, 0, 0, 0, 0, 0, 0, 0, 0, 0, 0, 3, 2, 1, 3, 0, 0, 0, 3, 0, 0, 0, 0, 0, 0, 0, 2, 1, 1, 1],
    [2, 0, 0, 2, 0, 0, 0, 0, 0, 0, 0, 1, 1, 4, 5, 2, 0, 0, 5, 0, 0, 4, 2, 0, 0, 0, 4, 1, 1, 1],
    [2, 0, 0, 2, 0, 0, 0, 0, 0, 0, 0, 2, 1, 1, 2, 2, 0, 0, 0, 0, 0, 1, 3, 0, 0, 0, 3, 1, 1, 1],
    [1, 0, 0, 1, 0, 0, 0, 0, 0, 0, 0, 0, 0, 0, 0, 0, 0, 0, 3, 0, 0, 0, 0, 0, 0, 0, 1, 1, 1, 1],
    [3, 0, 0, 2, 0, 0, 0, 0, 0, 0, 0, 0, 0, 0, 0, 0, 0, 0, 5, 0, 0, 2, 2, 0, 0, 0, 3, 1, 1, 1],
    [3, 0, 0, 4, 1, 1, 2, 2, 4, 1, 1, 2, 0, 0, 0, 0, 0, 0, 3, 0, 0, 0, 0, 0, 0, 0, 2, 1, 1, 1],
    [5, 0, 0, 0, 0, 0, 0, 0, 0, 0, 0, 0, 0, 0, 0, 0, 0, 0, 0, 0, 0, 3, 2, 0, 0, 0, 2, 1, 1, 1],
    [2, 0, 0, 0, 0, 0, 0, 0, 0, 0, 0, 0, 0, 0, 3, 0, 0, 0, 2, 0, 0, 1, 4, 0, 0, 0, 1, 1, 1, 1],
    [1, 1, 1, 5, 1, 5, 0, 0, 0, 0, 0, 0, 0, 0, 2, 0, 0, 0, 2, 0, 0, 0, 0, 0, 0, 0, 1, 1, 1, 1],
    [1, 3, 2, 2, 1, 2, 0, 0, 0, 0, 0, 0, 0, 0, 1, 0, 0, 0, 2, 0, 0, 1, 3, 0, 0, 0, 3, 1, 1, 1],
    [2, 3, 4, 1, 3, 3, 3, 2, 5, 3, 1, 3, 5, 3, 5, 2, 3, 3, 1, 3, 3, 1, 3, 5, 4, 3, 1, 1, 1, 1]],
  "player": {
    "start_pos": [4.5, 2.5],
    "speed": 2
  },
  "entities": [
    {
      "id": "test_npc",
      "pos": [7.5, 12.5]
    },
    {
      "id": "test_npc",
      "pos": [7.5, 21.5]
    },
    {
      "id": "test_npc",
      "pos": [7.5, 27.5]
    },
    {
      "id": "test_npc",
      "pos": [14.5, 3.5]
    },
    {
      "id": "test_npc",
      "pos": [14.5, 16.5]
    },
    {
      "id": "test_npc",
      "pos": [15.5, 23.5]
    },
    {
      "id": "test_npc",
      "pos": [24.5, 24.5]
    },
    {
      "id": "test_npc",
      "pos": [23.5, 9.5]
    },
    {
      "id": "test_npc",
      "pos": [24.5, 2.5]
    }

  ],
"endpoint": [10.5, 9.4]
}